あかのらくいん	赫の烙印	ja-JP
あだましあ	魔救	ja-JP
いんぜくたー	甲虫装機	ja-JP
えんせい	焔聖	ja-JP
えんまりゅう	琰魔竜	ja-JP
おーぱーつ	先史遺産	ja-JP
かいじゅう	壊獣	ja-JP
きかい	機塊	ja-JP
きんけん	金謙	ja-JP
きんてれ	緊テレ	ja-JP
くうがだん	空牙団	ja-JP
ぐらでぃあるびーすと	剣闘獣	ja-JP
ぐんかん	軍貫	ja-JP
げんえい	幻影	ja-JP
げんじゅうき	幻獣機	ja-JP
げんそう	幻奏	ja-JP
けんとうじゅう	剣闘獣	ja-JP
ごうきん	強金	ja-JP
ごうけん	強謙	ja-JP
ごうどん	強貪	ja-JP
こわくま	蟲惑魔	ja-JP
さうんどうぉりあー	音響戦士	ja-JP
さらまんぐれいど	転生炎獣	ja-JP
ざんき	斬機	ja-JP
じゅうにしし	十二獣	ja-JP
じゅがん	呪眼	ja-JP
しんりゅう	真竜	ja-JP
すふぃあもーど	球体形	ja-JP
せいいぶつ	星遺物	ja-JP
せいりゅう	征竜	ja-JP
せんとうき	閃刀姫	ja-JP
そうけん	相剣	ja-JP
でくれあらー	宣告者	ja-JP
てつじゅう	鉄獣	ja-JP
てんい	天威	ja-JP
でんのうかい	電脳堺	ja-JP
てんろうせつごく	天龍雪獄	ja-JP
とらいぶりげーど	鉄獣	ja-JP
どらぐま	教導	ja-JP
どらぐま	凶導	ja-JP
ねくろす	影霊衣	ja-JP
はおうけんりゅう	覇王眷竜	ja-JP
はかい	破械	ja-JP
はるけしょう	春化精	ja-JP
びーすてっど	深淵	ja-JP
びーとるーぱー	騎甲虫	ja-JP
まーめいる	水精鱗	ja-JP
ひすい	氷水	ja-JP
ふぁんとむないつ	幻影騎士団	ja-JP
ぷらんどろーる	海造賊	ja-JP
ぷれでたーぷらんつ	捕食植物	ja-JP
へいずびーすと	陽炎獣	ja-JP
ほうよう	泡影	ja-JP
まりんせす	海晶乙女	ja-JP
みかんこ	御巫	ja-JP
やたがらす	八汰烏	ja-JP
りゅうけんし	竜剣士	ja-JP
るーん	神碑	ja-JP